; Boulder Dash 1 caves for the Oric version of the game
; There are a few minor differences in this version compared to the original Peter Liepa version
; Dirt tiles in cave A at 6 8 and 28 12, not a boulder (pseudo-random generated) - affects demo mode
; Amoeba / Magic Walls times in caves G, H, M, O, P, T
; Firefly in a box starting positions in caves E, L, P
; Bonus caves are one column shorter

[BDCFF]

[game]
Name=Boulder Dash
Date=1984
Author=Peter Liepa with Chris Gray
WWW=http://www.boulder-dash.com/
Charset=Original
Fontset=Original
Caves=20
Levels=5

[cave]
Name=Cave A. Intro
Description=Pick up jewels and exit before time is up
DiamondValue=10 15
DiamondsRequired=12 12 12 12 12
CaveTime=150 110 70 40 30
Colors=Orange Gray1 White
RandSeed=10 11 12 13 14
RandomFill=SPACE 60 BOULDER 50 DIAMOND 9

[map]
WWWWWWWWWWWWWWWWWWWWWWWWWWWWWWWWWWWWWWWW
W--------------------------------------W
W--P-----------------------------------W
W--------------------------------------W
W--------------------------------------W
W--------------------------------------W
W--------------------------------------W
Wwwwwwwwwwwwwwwwwwwwwwwwwwwwwww--------W
W-----.--------------------------------W
W--------------------------------------W
W--------------------------------------W
W--------------------------------------W
W---------------------------.----------W
W--------------------------------------W
W--------wwwwwwwwwwwwwwwwwwwwwwwwwwwwwwW
W--------------------------------------W
W-------------------------------------XW
W--------------------------------------W
W--------------------------------------W
W--------------------------------------W
W--------------------------------------W
WWWWWWWWWWWWWWWWWWWWWWWWWWWWWWWWWWWWWWWW
[/map]

[demo]
.30 u1 r7 d2 r9 .4 d2 r4 u3 l1 .4 u1 r11 d1 r2 .4 d6 r1 d4 l3 .4 d1 l1 r4 l3 .4 u4 l5 u3 l5 d4 l3 .5 u3 l10 u1 l3 d1 l6 d4 r1 .4 d3 r4 d4 l4 u2 r2 u3 r20 d1 r4 d1 r4 d2 .5 r5 u4 r5 .6 d1
[/demo]

[/cave]

[cave]
Name=Cave B. Rooms
Description=Pick up jewels, but you must move boulders to get all jewels
DiamondValue=20 50
DiamondsRequired=10 12 9 13 10
CaveTime=150 110 70 70 70
Colors=LightRed Purple White
RandSeed=3 0 1 87 88
RandomFill=SPACE 60 BOULDER 50 DIAMOND 9 FIREFLYl 2

[map]
WWWWWWWWWWWWWWWWWWWWWWWWWWWWWWWWWWWWWWWW
W-------w-------w--- ---w-------w------W
W-------w-------w--- ---w-------w------W
W                                      W
W-------w-------w--- ---w-------w------W
W-------w-------w--- ---w-------w------W
Wwwwwwwwwwwwwwwwwwww wwwwwwwwwwwwwwwwwwW
W-------w-------w--- ---w-------w------W
W-------w-------w--- ---w-------w------W
W                                      W
W-------w-------w--- ---w-------w------W
W-------w-------w--- ---w-------w------W
W-------w-------w--- ---w-------w------W
Wwwwwwwwwwwwwwwwwwww wwwwwwwwwwwwwwwwwwW
W-------w-------w--- ---w-------w------W
W-------w-------w--- ---w-------w------W
W                                      W
W-------w-------w--- ---w-------w------W
W-------w-------w--- ---w-------w------W
W-------w-------w-P- ---w-------w------W
W-------w-------w-X- ---w-------w------W
WWWWWWWWWWWWWWWWWWWWWWWWWWWWWWWWWWWWWWWW
[/map]

[/cave]

[cave]
Name=Cave C. Maze
Description=Pick up jewels. You must get every jewel to exit
DiamondValue=15
DiamondsRequired=24 23 24 23 21
CaveTime=150 100 90 80 70
Colors=Brown Orange White
RandSeed=0 50 54 52 55
RandomFill=WALL 100 BOULDER 50 DIAMOND 9

[map]
WWWWWWWWWWWWWWWWWWWWWWWWWWWWWWWWWWWWWWWW
W--------------------------------------W
W--P-----------------------------------W
W--------------------------------------W
W--------------------------------------W
W--------------------------------------W
W--------------------------------------W
W--------------------------------------W
W--------------------------------------W
W--------------------------------------W
W--------------------------------------W
W--------------------------------------W
W--------------------------------------W
W--------------------------------------W
W--------------------------------------W
W--------------------------------------W
W--------------------------------------W
W--------------------------------------W
W--------------------------------------X
W--------------------------------------W
W--------------------------------------W
WWWWWWWWWWWWWWWWWWWWWWWWWWWWWWWWWWWWWWWW
[/map]

[/cave]

[cave]
Name=Cave D. Butterflies
Description=Drop boulders on butterflies to create jewels
DiamondValue=5 20
DiamondsRequired=36 36 36 36 36
CaveTime=120 100 80 60 50
Colors=Purple Orange White
RandSeed=0 110 112 115 119
RandomFill=BOULDER 20

[map]
WWWWWWWWWWWWWWWWWWWWWWWWWWWWWWWWWWWWWWWW
WP-------------------------------------W
W--------------------------------------W
W--------------------------------------W
W--------------------------------------W
W--------------------------------------W
W--------------------------------------W
W--------------------------------------W
W-------....----....----....----....---W
W-------. c.----. c.----. c.----. c.---W
W-------.  .----.  .----.  .----.  .---W
W-------....----....----....----....---W
W--------------------------------------W
W--------------------------------------W
W--------------------------------------W
W--------------------------------------W
W--------------------------------------W
W--------------------------------------W
W--------------------------------------W
W--------------------------------------W
W-------------------------------------XW
WWWWWWWWWWWWWWWWWWWWWWWWWWWWWWWWWWWWWWWW
[/map]

[/cave]

[cave]
Name=Intermission 1
Intermission=true
DiamondValue=30
DiamondsRequired=6 6 6 6 6
CaveTime=10 10 10 10 10
Colors=LightBlue Red White
InitialFill=SPACE

[map]
WWWWWWWWWWWWWWWWWWW 
W                 W 
W         r       W 
W  P      .       W 
W                 W 
W                 W 
W                 W 
W                 W 
W                 W 
W                 W 
W         c      XW 
WWWWWWWWWWWWWWWWWWW 
[/map]

[/cave]

[cave]
Name=Cave E. Guards
Description=The jewels are there for grapping, but they are guarded by the deadly fireflies
DiamondValue=50 90
DiamondsRequired=4 5 6 7 8
CaveTime=150 120 90 60 30
Colors=Brown LightRed White

[map]
WWWWWWWWWWWWWWWWWWWWWWWWWWWWWWWWWWWWWWWW
WP.....................................W
W......................................W
W......................................W
W......................................W
W......................................W
W......................................W
W......................................W
W.......   .....   .....   .....   ....W
W....... q ..... q ..... q ..... q ....W
W....... d ..... d ..... d ..... d ....W
W......................................W
W......................................W
W......................................W
W.......   .....   .....   .....   ....W
W....... q ..... q ..... q ..... q ....W
W....... d ..... d ..... d ..... d ....W
W......................................W
W......................................W
W......................................W
W......................................X
WWWWWWWWWWWWWWWWWWWWWWWWWWWWWWWWWWWWWWWW
[/map]

[/cave]

[cave]
Name=Cave F. Firefly dens
Description=Each firefly is guarding a jewel
DiamondValue=40 60
DiamondsRequired=4 6 7 8 8
CaveTime=150 120 100 90 80
Colors=LightBlue LightRed White
RandSeed=0 20 21 22 23
RandomFill=BOULDER 50

[map]
WWWWWWWWWWWWWWWWWWWWWWWWWWWWWWWWWWWWWWWW
Wwwwwwwwww.------------------.wwwwwwwwwW
Ww        .------------------.        wW
Ww dq     .------------------.     qd wW
Wwwwwwwwww.------------------.wwwwwwwwwW
Ww        .------------------.        wW
Ww dq     .------------------.     qd wW
Wwwwwwwwww.------------------.wwwwwwwwwW
Ww        .------------------.        wW
Ww dq     .------------------.     qd wW
Wwwwwwwwww.------------------.wwwwwwwwwW
Ww        .------------------.        wW
Ww dq     .------------------.     qd wW
Wwwwwwwwww.------------------.wwwwwwwwwW
W--------------------------------------W
W--------------------------------------W
W--------------------------------------W
W--------------------------------------W
W--P----------------------------------XW
W--------------------------------------W
W--------------------------------------W
WWWWWWWWWWWWWWWWWWWWWWWWWWWWWWWWWWWWWWWW
[/map]

[/cave]

[cave]
Name=Cave G. Amoeba
Description=Surround the amoeba with boulders, so it can't grow anymore. Pick up jewels that are created when it suffocates
DiamondValue=10 20
DiamondsRequired=15 20 25 25 25
CaveTime=120 120 120 120 120
Colors=Brown LightRed Green
RandSeed=2 7 8 10 9
RandomFill=SPACE 100 BOULDER 40 FIREFLYl 2
AmoebaTime=40

[map]
WWWWWWWWWWWWWWWWWWWWWWWWWWWWWWWWWWWWWWWW
W-------------------P------------------W
W---------------------------------d----W
W---------------------------wwwwwwwwwwwW
W---d----------------------------------W
Wwwwwwwwwwwww--------------------------X
W--------------------------------------W
W--------------------------------------W
W--------------------------------------W
W--------------------------------------W
W---------------------------------d----W
W--------------------------------------W
W---d----------------------------------W
W--------------------------------------W
W--------------------------------------W
W--------------------------------------W
W--------------------------------------W
W--------------------------------------W
W--------------------------------------W
W------------------aa------------------W
W---d-----------------------------d----W
WWWWWWWWWWWWWWWWWWWWWWWWWWWWWWWWWWWWWWWW
[/map]

[/cave]

[cave]
Name=Cave H. Enchanted wall
Description=Activate the enchanted wall and create as many jewels as you can
DiamondValue=10 20
DiamondsRequired=10 15 20 20 20
CaveTime=120 110 100 90 80
Colors=Red LightBlue White
RandSeed=1 3 4 5 6
RandomFill=SPACE 90 BOULDER 50 FIREFLYl 2
MagicWallTime=25

[map]
WWWWWWWWWWWWWWWWWWWWWWWWWWWWWWWWWWWWWWWW
W-------------------P------------------W
W---------------------------------d----W
X---------------------------wwwwwwwwwwwW
W---d----------------------------------W
Wwwwwwwwwwwww--------------------------W
W--------------------------------------W
W--------------------------------------W
W--------------------------------------W
W--------------------------------------W
W---------------------------------d----W
W---------------------------wwwwwwwwwwwW
W--------------------------------------W
Wwwwwwwwwwwww-........-----------------W
W-----------d--------------------------W
W-------------MMMMMMMM-----------------W
W------------- ----d-------------------W
W--------------------------------------W
W--------------------------------------W
W--------------------------------------W
W--------------------------------------W
WWWWWWWWWWWWWWWWWWWWWWWWWWWWWWWWWWWWWWWW
[/map]

[/cave]

[cave]
Name=Intermission 2
Intermission=true
DiamondValue=10
DiamondsRequired=16 16 16 16 16
CaveTime=15 15 15 15 15
Colors=Blue Gray3 White

[map]
WWWWWWWWWWWWWWWWWWW 
Wrq..............rW 
WPrq............rXW 
Wd.rq..........r.dW 
Wrd.rq........r.drW 
W.rd.rq......r.dr.W 
W..rd.rq....r.dr..W 
W...rd.rq..r.dr...W 
W....rd.r.r.dr....W 
W.....rd.r.dr.....W 
W......rd.dr......W 
WWWWWWWWWWWWWWWWWWW 
[/map]

[/cave]

[cave]
Name=Cave I. Greed
Description=You have to get a lot of jewels here, lucky there are so many
DiamondValue=5 10
DiamondsRequired=75 75 80 85 90
CaveTime=150 150 130 130 120
Colors=Orange Purple White
RandSeed=100 137 140 251 51
RandomFill=BOULDER 240 DIAMOND 120

[map]
WWWWWWWWWWWWWWWWWWWWWWWWWWWWWWWWWWWWWWWW
W--------------------------------------W
W--------------------------------------W
W--------------------------------------W
W--------------------------------------W
W--------------------------------------W
W--------------------------------------W
W--------------------------------------W
W----wwwwwww.wwwww-------wwwwww.wwwwww-W
W----w           w-------w           w-W
W----w PX        w-------w           w-W
W----w           w-------w           w-W
W----w           w-------w           w-W
W----w           w-------w           w-W
W----w           w-------w           w-W
W----w           w-------w           w-W
W----w           wwwwwwwww           w-W
W----w                               w-W
W----w           w-------w           w-W
W----w           w-------w           w-W
W----wwwwwwwwwwwww-------wwwwwwwwwwwww-W
WWWWWWWWWWWWWWWWWWWWWWWWWWWWWWWWWWWWWWWW
[/map]

[/cave]

[cave]
Name=Cave J. Tracks
Description=Get the jewels, avoid the fireflies
DiamondValue=25 60
DiamondsRequired=12 12 12 12 12
CaveTime=150 130 120 110 100
Colors=Blue Orange White

[map]
WWWWWWWWWWWWWWWWWWWWWWWWWWWWWWWWWWWWWWWW
W............P.........................W
Wwwwwwwwwwwww wwwwwwww.................W
Ww....d.............dw.................W
Ww.w w.wwwwww wwwwww.w.................W
Ww.wqw.wd.........dw.w.................W
Ww.wqw.w.wwww wwww.w.w.................W
Ww.wqw.w.wd.....dw.w.w.................W
Ww.wqw.w.w.ww ww.w.w.w.................W
Ww.wqw w w w   w w w w.................W
Ww.wqwqwqwqwqqqwqwqwqw.................W
Ww.wqw w w w   w w w w.................W
Ww.wqw.w.w.wwwww.w.w.w.................W
Ww.wqw.w.wd.....dw.w.w.................W
Ww.wdw.w.wwwwwwwww.w.w.................W
Ww.wdw.wd.........dw.w.................W
Ww.wdw.wwwwwwwwwwwww.w.................W
Ww.wdwd.............dw.................W
Wwwwwwwwwwwwwwwwwwwwww.................W
W......................................W
W......................................X
WWWWWWWWWWWWWWWWWWWWWWWWWWWWWWWWWWWWWWWW
[/map]

[/cave]

[cave]
Name=Cave K. Crowd
Description=You must move a lot of boulders around in some tight spaces
DiamondValue=50
DiamondsRequired=6 6 6 6 6
CaveTime=120 120 150 150 240
Colors=Gray1 Orange White
RandSeed=0 4 102 151 100
RandomFill=SPACE 100 BOULDER 80 FIREFLYl 2

[map]
WWWWWWWWWWWWWWWWWWWWWWWWWWWWWWWWWWWWWWWW
W---d-----w---d-----w---d-----w---d----W
W---------w---------w---------w--------W
W---------w---------w---------w--------W
W---------w---------w---------w--------W
W---------w---------w---------w--------W
W---------w---------w---------w--------W
W---------w---------w---------w-------wW
W---------w---------w---------w------w-W
W----wwwwwwwww-wwwwwwwww-wwwwwwwww--w--W
W----------------------------------w---W
W---------------------------------w----W
W--------------------------------w-----W
W-----------wwwwwwwwwwwwwwwww---w------W
W------------------------------w-------W
W-----------------------------w-------XW
W----------------------------w---------W
W---------------------------w----------W
W-------------------P------------------W
W----------------------------------d---W
W---d----------------------------------W
WWWWWWWWWWWWWWWWWWWWWWWWWWWWWWWWWWWWWWWW
[/map]

[/cave]

[cave]
Name=Cave L. Walls
Description=You must blast through walls to get at some of the jewels. Drop a boulder on a firefly at the right time and place to do this
DiamondValue=20
DiamondsRequired=19 19 14 16 21
CaveTime=180 170 160 160 160
Colors=Gray2 LightRed White
RandSeed=0 60 2 59 102
RandomFill=SPACE 60 BOULDER 50 DIAMOND 9

[map]
WWWWWWWWWWWWWWWWWWWWWWWWWWWWWWWWWWWWWWWW
W--------------------------------------W
W-----------------------------....-----W
W---------w---w---w---w-------.q .-----W
W-wwwwwwwwwww-w---w---w-------.  .-----W
W---------w---w---w---w-------....-----W
W---------w---w---w---w----------------W
W---------w---w---w---w-------....-----W
W-wwwwwwwwwww-w---w---w-------.q .-----W
W---------w---w---w---w-------.  .-----W
W---------w---w---w---w-------....-----W
W---------w---w---w---w----------------W
W-wwwwwwwwwwwwwww-w---w-------....-----W
W---------w---w---w---w-------.q .-----W
W---------w---w---w---w-------.  .-----W
W---------w---w---w---w-------....-----W
W-wwwwwwwwwww-w---w---w----------------W
W---------w---w---w---w----------------W
W--P------w---w---w---w----------------W
W---------w---w---w---w----------------W
W---------w---w---w---w----------------X
WWWWWWWWWWWWWWWWWWWWWWWWWWWWWWWWWWWWWWWW
[/map]

[/cave]

[cave]
Name=Intermission 3
Remark=Unsolvable on PAL systems.
Intermission=true
DiamondValue=10
DiamondsRequired=13 13 13 13 13
CaveTime=20 20 20 20 20
Colors=Blue Orange White
InitialFill=SPACE

[map]
WWWWWWWWWWWWWWWWWWW 
W       P         W 
W                 W 
W                 W 
W                 W 
W                XW 
W                 W 
W             qqqqW 
W             qqqqW 
W             qqqqW 
WdddddddddddddqqqqW 
WWWWWWWWWWWWWWWWWWW 
[/map]

[/cave]

[cave]
Name=Cave M. Apocalypse
Description=Bring the butterflies and amoeba together and watch the jewels fly
DiamondValue=5 8
DiamondsRequired=50 55 60 70 80
CaveTime=160 155 150 145 140
Colors=Blue Orange Green
RandSeed=0 1 2 3 4
RandomFill=BOULDER 40
AmoebaTime=32

[map]
WWWWWWWWWWWWWWWWWWWWWWWWWWWWWWWWWWWWWWWW
W---------X-------P-a------------------W
W--------------------------------------W
W--------------------------------------W
W--------------------------------------W
W--------------------------------------W
W--------------------------------------W
W--------------------------------------W
W--------------------------------------W
W--------------------------------------W
W--------------------------------------W
W--------------------------------------W
W--------------------------------------W
W--------------------------------------W
W--------------------------------------W
W--------------------------------------W
W----wwwwwwwwwwwwwwwwwwwwwwwwwwwwww----W
W----cccccccccccccccccccccccccccccc----W
W----rrrrrrrrrrrrrrrrrrrrrrrrrrrrrr----W
W----..............................----W
W----..............................----W
WWWWWWWWWWWWWWWWWWWWWWWWWWWWWWWWWWWWWWWW
[/map]

[/cave]

[cave]
Name=Cave N. Zigzag
Description=Magically transform the butterflies into jewels, but don't waste any boulders and watch out the fireflies
DiamondValue=10 20
DiamondsRequired=30 35 40 42 45
CaveTime=150 145 140 135 130
Colors=Gray2 Orange White

[map]
WWWWWWWWWWWWWWWWWWWWWWWWWWWWWWWWWWWWWWWW
W..P...................................W
W......................................W
W......................................W
W......................................W
W.....................q.q.q.q.q.q......W
W.....................r.r.r.r.r.r......W
W......................................W
W......................................W
W..........c. . . . . .................W
W.......... . . . . . .................W
W.......... .c. . . . .................W
W.......... . . . . . .................W
W.......... . .c. . . .................W
W.......... . . . . . .................W
W.......... . . .c. . .................W
W.......... . . . . . .................W
W.......... . . . .c. .................W
W.......... . . . . . .................X
W.......... . . . . .c.................W
W......................................W
WWWWWWWWWWWWWWWWWWWWWWWWWWWWWWWWWWWWWWWW
[/map]

[/cave]

[cave]
Name=Cave O. Funnel
Description=There is an enchanted wall at the bottom of the rock tunnel
DiamondValue=10 20
DiamondsRequired=15 20 20 25 30
CaveTime=120 120 120 120 140
Colors=Orange LightBlue White
RandSeed=1 29 30 31 32
RandomFill=SPACE 100 BOULDER 80 FIREFLYl 2
MagicWallTime=10

[map]
WWWWWWWWWWWWWWWWWWWWWWWWWWWWWWWWWWWWWWWW
W-------------------P------------------W
W-w---------------------w--------------W
W--w-------------------w---------------W
W---w-----------------w----------------W
W----w---------------w-----------------W
W-----w-------------w------------------W
W------w-----------w-------------------W
W-------w---------w--------------------W
W--------w-------w---------------------W
W---------w-----w----------------------W
W----------w---w-----------------------W
W-----------...------------------------W
W-----------MMM------------------------W
W--------------------------------------W
W--------------------------------------W
W--------------------------------------W
W--------------------------------------W
W--------------------------------------W
W--------------------------------------W
W-------------------X------------------W
WWWWWWWWWWWWWWWWWWWWWWWWWWWWWWWWWWWWWWWW
[/map]

[/cave]

[cave]
Name=Cave P. Enchanted boxes
Description=The top of each square room is an enchanted wall, but you'll have to blast your way inside
DiamondValue=10 20
DiamondsRequired=12 15 15 15 12
CaveTime=150 150 150 150 150
Colors=Brown LightRed White
RandSeed=1 120 129 126 123
RandomFill=BOULDER 50
MagicWallTime=20

[map]
WWWWWWWWWWWWWWWWWWWWWWWWWWWWWWWWWWWWWWWW
WP-------------------------------------W
W--------------------------------------X
W--------------------------------------W
W--------------------------------------W
W--------------------------------------W
W--------------------------------------W
W--------------------------------------W
W------MMMMMM--MMMMMM------------------W
W------w----w--w----w------------------W
W------w----w--w----w------------------W
W------w----w--w----w------------------W
W------w----w--w----w------------------W
W------w----w--w----w------------------W
W------w----w--w----w------------------W
W------wwwwww--wwwwww------------------W
W--------------------------------------W
W-------....----....----....----....---W
W-------.q .----.q .----.q .----.q .---W
W-------.  .----.  .----.  .----.  .---W
W-------....----....----....----....---W
WWWWWWWWWWWWWWWWWWWWWWWWWWWWWWWWWWWWWWWW
[/map]

[/cave]

[cave]
Name=Intermission 4
Intermission=true
DiamondValue=30
DiamondsRequired=6 6 6 6 6
CaveTime=20 20 20 20 20
Colors=Blue Orange White
MagicWallTime=4

[map]
WWWWWWWWWWWWWWWWWWW 
W..P.......rrr....W 
W..........rrr....W 
W.................W 
W..........MMM....W 
W.......r..   ....W 
W........r.   ....W 
W.........r   ....W 
W........X.MMM....W 
W..........   ....W 
W..........   ....W 
WWWWWWWWWWWWWWWWWWW 
[/map]

[/cave]

[cave]
Name=Cave 21
DiamondValue=1
DiamondExtraValue=1
DiamondsRequired=1 1 1 1 1
CaveTime=10 10 10 10 10
Colors=Blue Purple Yellow

[map]
WWWWWWWWWWWWWWWWWWWWWWWWWWWWWWWWWWWWWWWW
W                 W                    W
W   r r r r r r   W                    W
W  wwwwwwwwwwwww  W                    W
ss sa         as ss                    W
ss s           s ss                    W
ss sxxxxxxxxxxxs ss                    W
ss sa         as ss                    W
W  wwwwwwwwwwwww  W                    W
W                 W                    W
Wqrcr r r r r rqrcW                    W
WWWWW WWWWW WWWWWWW                    W
Wq               cW                    W
WWWWWWWWWWWWWWWWWWW                    W
W                                      W
W                                      W
W                                      W
W                                      W
W                                      W
W                                      W
W                                      W
WWWWWWWWWWWWWWWWWWWWWWWWWWWWWWWWWWWWWWWW
[/map]

[/cave]

[/game]

[/BDCFF]